63
43
111111111111111111111111111110000011111111111111111111111111111
111111111111111111111111111110000011111111111111111111111111111
111111111111111111111111111110000011111111111111111111111111111
110110111111111111100110011110000011110011011000111000110110011
110000011111111111000000011110000011110000000000000000000000011
110000000000000000000000000010000000000000000000000000000000011
110000000000000000000000000000000000000000000000000000000000011
111000000000000000000001111000000000111100000000000000000000011
111000000000000000000000000000000000111100000000000000000000011
111000000000000000000000000000000000111100000000000000000000011
111000000000000000000000000000000010000000000000000010000000111
111000000000000000000000000000000000000000000000000000000111111
111110111111111000000011111110000011111111111111111110000011111
111110000000000000000000000000000011111111111111111110000111111
111000000011111111111111111110000000001111111000000000000111111
111000000011111111111111111110000000001111111000000000000111111
111000000001111111111111111110000000000111110000000000000111111
111000000001111111111111110000000000000111100000000000000111111
111000000000000000000000000000000000000000000000000000000111111
111000000001111111111111110000000000000111100000000000000111111
111000000000000000000000000000000000000000000000000000000111111
111000000000000000000000000000000000000000000000000000000111111
111000000000000000000000000000000000000000000000000000000111111
111000000000000000000000000000000000000000000000000000000111111
111000000000000000000000000000000000000000000000000000000001011
111000000000000000000000000000000000000000000000000000000001011
111000000000000000000000000000000000000000000000000000000000011
111000000000000000000000000000000000000000000000000000000000011
111000000000000000000000000000000000000000000000000000000000011
111000000000000000000000000000000000000000000000000000000000011
111000000000000000000000000000000000000000000000000000000000011
111000000000000000000000000000000000000000000000000000000000011
111000000000000000000000000000000000000000000000000000000000011
111000000000000000000000000000000000000000000000000000000000011
111000000000000000000000000000000000000000000000000000000000011
110000001111111110000000011110000000000000000000000000000000111
110000011111111111000000011110000000000000000000000000000000111
110000000000000000000000011110000000000000011111111110000000011
110000000000000000000000000000000000000000011111111110000000011
110000000000000000000000000000000000000000011111111110000000011
111111111111111111111111111111111111111111111111111111111111111
111111111111111111111111111111111111111111111111111111111111111
111111111111111111111111111111111111111111111111111111111111111

